k æ ɹ ɪ d͡ʒ	k a j ɪ t͡ʃ
m u n	m u n
t e ɪ ɫ	t e ɪ ɫ
b ə ɫ b	b ə - b
h ʊ k	h ʊ k
w ɹ̩ m	w ɹ m
k o ʊ t	k o ʊ t
b ɹ e ɪ n	- ɹ e ɪ n
p ɑ t	p ɑ t
ɫ ɛ ɡ	ɫ ɛ k
f ɪ ʃ	f ɪ ʃ
n i	n i
n i d ə ɫ	n i j ə ɫ
n ə t	n ə t
s ɹ̩ k ə ɫ	s ɹ k ə ɫ
k ə p	k ə p
n ɛ t	n ɛ t
ɛ ɡ	ɛ k
h æ n d	h a - d
h ɑ ɹ t	h ɑ - d
p ɪ n	p ɪ n
b e ɪ b i	b e ɪ j i
w ɔ ɫ	w ɔ ɫ
b u t	b u t
p a ɪ p	p a ɪ p
ɹ i s i t	ɹ i s i t
b ɹ æ n t͡ʃ	- ɹ a - d͡ʒ
ɔ ɹ ə n d͡ʒ	ɔ j ə - d͡ʒ
- s p ɹ ɪ ŋ	ə - p ɹ ɪ ŋ
p ɪ ɡ	p ɪ k
s - n e ɪ k	s ə n e ɪ k
t͡ʃ e ɪ n	t͡ʃ e ɪ n
- s t ə m ə k	ə - t ə m ə k
b ɹ ə ʃ	- ɹ ə ʃ
p ɫ e ɪ n	- ɫ e ɪ n
d ɹ ɑ p	- ɹ ɑ p
d ɹ e ɪ n	- ɹ e ɪ n
h ɔ ɹ n	h ɔ - n
ɑ ɹ m	ɑ - m
h æ m ɹ̩	h a m ɹ
k ɹ̩ t ə n	k ɹ t ə n
ɫ i f	ɫ i f
n ɛ k	n ɛ k
p ɫ a ʊ	- ɫ ɑ ʊ
d ɔ ɹ	d ɔ ɹ
ɹ ɪ ŋ	ɹ ɪ ŋ
- s t ɹ i t	ə - t ɹ i t
t ɹ i	- ɹ i
ɑ ɹ t͡ʃ	ɑ - d͡ʒ
t͡ʃ ɛ s t	t͡ʃ ɛ - t
ɫ ɑ k	ɫ ɑ k
- s p u n	ə - p u n
- s t æ m p	ə - t a - b
p ɪ k t͡ʃ ɹ̩	p ɪ - t͡ʃ ɹ
ɡ ɫ ə v	- ɫ ə f
æ p ə ɫ	a p ə ɫ
h æ t	h a t
ɑ ɹ m i	ɑ - m i
k æ m ɹ̩ ə	k a m ɹ ə
n a ɪ f	n a ɪ f
- s t ɑ ɹ	ə - t ɑ ɹ
d͡ʒ u ə ɫ	d͡ʒ u ə ɫ
n e ɪ ɫ	n e ɪ ɫ
p ɑ k ə t	p ɑ k ə t
p ə t e ɪ t o ʊ	p ə t e ɪ t o ʊ
f ʊ t	f ʊ t
ɹ u f	ɹ u f
f - ɫ ɔ ɹ	f ə j ɔ ɹ
f ɪ ŋ ɡ ɹ̩	f ɪ - ɡ ɹ
k ʊ ʃ ə n	k ʊ ʃ ə n
d ɹ ɛ s	- ɹ ɛ s
b ʊ k	b ʊ k
b æ θ	b a θ
ə v ə n	ə v ə n
ɫ ɪ p	ɫ ɪ p
ʃ ɹ̩ t	ʃ ɹ t
b ɫ e ɪ d	- ɫ e ɪ t
d ɹ ɔ ɹ	- ɹ ɔ ɹ
- s t ɛ m	ə - t ɛ m
ɛ n d͡ʒ ə n	ɛ - d͡ʒ ə n
h w i ɫ	- w i ɫ
w a ɪ ɹ̩	w a ɯ ɹ
h w ɪ p	- w ɪ p
h w ɪ s ə ɫ	- w ɪ s ə ɫ
k æ t	k a t
b æ ɡ	b a k
- s p e ɪ d	ə - p e ɪ t
k ɑ ɫ ɹ̩	k ɑ j ɹ
k ɑ ɹ t	k ɑ - d
ə m b ɹ ɛ ɫ ə	ə - b ɹ ɛ j ə
a ɪ ɫ ə n d	a ɪ j ə - d
ɡ ɑ ɹ d ə n	ɡ ɑ - d ə n
æ ŋ ɡ ə ɫ	a - ɡ ə ɫ
b ɔ ɪ	b œ ɪ
ɹ e ɪ ɫ	ɹ e ɪ ɫ
ɹ æ t	ɹ a t
b æ n d	b a - d
ɹ u t	ɹ u t
p ɛ n	p ɛ n
p ɹ ɪ z ə n	- ɹ ɪ z ə n
b ɛ ɹ i	b ɛ j i
ɡ o ʊ t	ɡ o ʊ t
h ɑ s p ɪ t ə ɫ	h ɑ - p ɪ t ə ɫ
m ə s ə ɫ	m ə s ə ɫ
f ɑ ɹ m	f ɑ - m
w ɪ ŋ	w ɪ ŋ
f ɛ ð ɹ̩	f ɛ ð ɹ
b e ɪ s ə n	b e ɪ s ə n
d ɔ ɡ	d ɔ k
s ɪ z ɹ̩ z	s ɪ z ɹ s
k ɛ t ə ɫ	k ɛ t ə ɫ
k ɫ a ʊ d	- ɫ ɑ ʊ t
ɹ ɑ d	ɹ ɑ t
- s k u ɫ	ə - k u ɫ
b ɑ t ə ɫ	b ɑ t ə ɫ
b ɔ ɫ	b ɔ ɫ
t ə ŋ	t ə ŋ
t ɹ a ʊ z ɹ̩ z	- ɹ ɑ ʊ z ɹ s
b o ʊ n	b o ʊ n
b ɛ ɫ	b ɛ ɫ
f ɔ ɹ k	f ɔ - ɡ
h ɔ ɹ s	h ɔ - z
n ɑ t	n ɑ t
b ɹ̩ d	b ɹ t
m ə ŋ k i	m ə - ɡ i
t o ʊ	t o ʊ
k a ʊ	k ɑ ʊ
m æ t͡ʃ	m a t͡ʃ
ɔ f ɪ s	ɔ f ɪ s
s ə n	s ə n
k i	k i
θ - ɹ o ʊ t	θ ə j o ʊ t
b ə k ə t	b ə k ə t
f - ɹ e ɪ m	f ə j e ɪ m
t u θ	t u θ
f a ʊ ɫ	f ɑ ʊ ɫ
m æ p	m a p
t ɹ e ɪ	- ɹ e ɪ
k ɔ ɹ d	k ɔ - d
k ɑ ɹ d	k ɑ - d
- s t e ɪ ʃ ə n	ə - t e ɪ ʃ ə n
n o ʊ z	n o ʊ s
ɡ ə n	ɡ ə n
f e ɪ s	f e ɪ s
p ɫ e ɪ t	- ɫ e ɪ t
f - ɫ æ ɡ	f ə j a k
i ɹ	i ɹ
t ɪ k ə t	t ɪ k ə t
w ɪ n d o ʊ	w ɪ - d o ʊ
b ɑ k s	b ɑ - s
s ɑ k	s ɑ k
- s p ə n d͡ʒ	ə - p ə - d͡ʒ
ɡ ɹ̩ ɫ	ɡ ɹ ɫ
- s k ɪ n	ə - k ɪ n
t e ɪ b ə ɫ	t e ɪ j ə ɫ
ʃ ɪ p	ʃ ɪ p
θ - ɹ ɛ d	θ ə j ɛ t
b ɛ d	b ɛ t
- s k ɹ u	ə - k ɹ u
t͡ʃ ɹ̩ t͡ʃ	t͡ʃ ɹ t͡ʃ
h ɛ ɹ	h ɛ ɹ
s i d	s i t
ɫ a ɪ n	ɫ a ɪ n
b o ʊ t	b o ʊ t
- s k w ɛ ɹ	ə - k w ɛ ɹ
t͡ʃ ɪ n	t͡ʃ ɪ n
ɫ a ɪ b ɹ ɛ ɹ i	ɫ a ɪ - ɹ ɛ j i
- s k ɹ̩ t	ə - k ɹ t
b ɹ e ɪ k	- ɹ e ɪ k
n ɹ̩ v	n ɹ f
p ɑ ɹ s ə ɫ	p ɑ - z ə ɫ
k ɫ ɑ k	- ɫ ɑ k
ʃ u	ʃ u
w ɑ t͡ʃ	w ɑ t͡ʃ
b i	b i
t ɹ e ɪ n	- ɹ e ɪ n
b ɔ ɹ d	b ɔ - d
ʃ ɛ ɫ f	ʃ ɛ - v
- s t ɔ ɹ	ə - t ɔ ɹ
m a ʊ θ	m ɑ ʊ θ
- s t ɪ k	ə - t ɪ k
s e ɪ ɫ	s e ɪ ɫ
b æ s k ə t	b a - k ə t
b ə t ə n	b ə t ə n
b ɹ ɪ d͡ʒ	- ɹ ɪ t͡ʃ
p ə m p	p ə - b
h a ʊ s	h ɑ ʊ s
p ɛ n s ə ɫ	p ɛ d z ə ɫ
b ɹ ɪ k	- ɹ ɪ k
t͡ʃ i z	t͡ʃ i s
æ n t	a - d
ʃ i p	ʃ i p
t a ʊ n	t ɑ ʊ n
θ ə m	θ ə m
- s t ɑ k ɪ ŋ	ə - t ɑ k ɪ ŋ
k o ʊ m	k o ʊ m
a ɪ	a ɪ
h ɛ d	h ɛ t
f - ɫ a ɪ	f ə j a ɪ
k e ɪ k	k e ɪ k
